EA ./textures/purplestone.xpm

R 600 400
NO ./textures/bluestone.xpm
SO ./textures/greystone.xpm
WE ./textures/mossy.xpm

F 128,128,128

S ./textures/fox.xpm

C 211,211,211

                1111111111
11111111111111111110020001111111111111111111111111111111111111
1000000000100000020000000000000000001100000000000000001111
11111000111000000000S00000000110000011100020000000010000211
    1200000000000000000001000012000000000000000111111000111
1111100001110000000000001000011000001110000000100001000111
10000000001100200111011110000000000001100000111011110001
111101111000000111000000100011101111111110111000000100011111
  101100001100111010100000011101100001110111010100000000001
111100101001010110000000000010000101101010110010000000011111
10002011110100000000000000000002011110100000001000000001
10000000000000001101010010000000000000000001101010010001
1100001111010101111101111000100000011010101111101111000111
1111011  1111101111111  1110001110111111100000111011110001
1111111  1111111111111  1111111111111111111111111111111111