R  1200 800
NO ./textures/greystone.xpm
SO ./textures/greystone.xpm
WE ./textures/greystone.xpm
EA ./textures/greystone.xpm

S ./textures/fox.xpm
F 128,128,128
C 211,211,211

  111111111111111111111111111111111111111111111111111111
  110000001100000020000200000000000001100000000000000001
11110000011100020000000010000110000011100020000000010001
101200000000200200200N0010000120000000000000001111110001
10110000011100000000000010000110000011100000001000010001
10000000001100000111011110000000000001100000111011110001
11110111111111011100000010001110111111111011100000010001
11110110000111011101010000001110110000111011101010000001
11000010110101011000000000001000010110101011001000000001
10002011110100000000000000000002011110100000001000000001
10000000000000001101010010000000000000000001101010010001
11000000110101011111011110001000000110101011111011110001
11110111111101011111011110001110111111101011111011110001
11111111111111111111111111111111111111111111111111111111
